明月=minh nguyệt
朝阳=triêu dương
无垢=vô cấu
晨曦=thần hi/tia nắng ban mai
专业=chuyên nghiệp/chuyên ngành
的话=lời nói/mà nói
不快,=không khoái,
会,=hội,/sẽ,/biết,
那=cái kia/cái nào/vậy
抽空=rút sạch
枪身=thân thương/thân súng
持枪=cầm thương/cầm súng
一枪=một thương/một phát súng
我的枪=thương của ta/súng của ta
这把枪=thanh thương này/khẩu súng này
一把枪=một thanh thương/một khẩu súng
握枪=cầm thương/cầm súng
枪柄=chuôi thương/báng súng
枪法=thương pháp/thuật bắn súng
手中的枪=thương trong tay/súng trong tay
装=trang
莲=liên
飞=phi
马=mã
田=điền
画=họa/vẽ
过去=quá khứ/đi qua
大家伙=đại gia hỏa
狙击=đánh lén/ngắm bắn
重活=việc nặng(sống lại)
制服=chế phục/đồng phục
四点=bốn điểm
五分=năm phần
六分=sáu phần
七分=bảy phần
八分=tám phần
九分=chín phần
天空=thiên không
走光=đi hết
不错=không sai
不错,=không sai,
太阳=thái dương
不死=bất tử
有种=có loại
第一=đệ nhất
影子=ảnh tử
暗流=ám lưu
分了=phân
池=trì
雁=nhạn
云=vân/mây
山=sơn
骑=kỵ
日=nhật
隼=chuẩn
苗=miêu
连=liền
龙=long
辛=tân
紫=tử
连=liền
蛇=xà
市=thị
迅=tấn
线=tuyến/dây
帅=soái
虹=hồng
道=đạo
旗=kỳ
美=mỹ
桑=tang
焦=tiêu
分=phân
蝉=thiền
牢=lao
彬=bân
允=doãn
岳=nhạc
少=thiếu
昌=xương
泡=phao
长=trường
琴=cầm
血=huyết
风=phong
天=thiên
暗=ám
娘=nương
图=đồ
陶=đào
等等=chờ chút
不一样=không đồng dạng
不想=không nghĩ
不要=không muốn
想=nghĩ
穿=xuyên
不穿=không xuyên
要=muốn
草=thảo
会=sẽ
正在=ngay tại
为=vì
等=chờ
老=lão
一点=một điểm
大人=đại nhân
回复=hồi phục
不死=bất tử/không chết
当=đương/khi/làm
坐下=tọa hạ/ngồi xuống
修=tu
回复=hồi phục
网络=mạng lưới
林=lâm
做小=làm tiểu
叫=gọi
一贯=nhất quán
这对=này đôi
叶=diệp
松=tùng
做小=làm tiểu
顾=cố
光=quang
经=kinh
真人=chân nhân
门=môn
教=giáo
月=nguyệt
大汗=đại hãn
黄裳=hoàng thường
生气=sinh khí
布=bố
滚=lăn
经=kinh
六道=lục đạo
松=tùng
母=mẫu
教授=giáo thụ
或者=hoặc là
还是=vẫn là/hay là
星空=tinh không