㶉鶒=khê xích
一丘之貉=nhất khưu chi lạc
一叶弊目=nhất diệp tế mục
一命呜呼=nhất mệnh minh hô
一座=nhất toà
一时=nhất thời
一暴十寒=nhất bộc thập hàn
一朝一夕=nhất triêu nhất tịch
一物降一物=nhất vật hàng nhất vật
一目十行=nhất mục thập hàng
一脉相传=nhất mạch tương truyền
一衣带水=nhất y đới thuỷ
一触即溃=nhất xúc tức hối
一蹶不振=nhất quệ bất chấn
丁当=đinh đang
七十二行=thất thập nhị hàng
万变不离其宗=vạn biến bất ly kỳ tông
万寿无疆=vạn thọ vô cương
万马齐喑=vạn mã tề âm
三分=tam phần
三台=tam thai
三灾八难=tam tai bát nạn
三藏=tam tạng
上市=thướng thị
上疏=thượng sớ
下场=hạ tràng
不应=bất ưng
不当=bất đáng
不时=bất thời
不时间=bất thì gian
不胜=bất thăng
不舍=bất xả
不要=bất yêu
不识时务=bất thức thời vụ
不辍=bất xuyết
丑时=sửu thời
丑闻=xú văn
专使=chuyên sứ
世外桃源=thế ngoại đào viên
世界银行=thế giới ngân hàng
丞相=thừa tướng
两小无猜=lưỡng tiểu vô xai
丧生=táng sinh
中举=trúng cử
中伤=trúng thương
中孚=trung phu
中式=trúng thức
中暑=trúng thử
中格=trúng cách
中毒=trúng độc
中用=trúng dụng
中计=trúng kế
中选=trúng tuyển
中酒=trúng tửu
中风=trúng phong
中食=trúng thực
临时=lâm thời
为人作嫁=vị nhân tác giá
为虎作伥=vị hổ tác xương
主宰=chúa tể
乐不思蜀=lạc bất tư thục
乐善好施=lạc thiện hảo thi
乐园=lạc viên
乐天知命=lạc thiên tri mệnh
乐极生悲=lạc cực sinh bi
乘兴而来=thừa hứng nhi lai
九回肠=cửu hồi trường
九重=cửu trùng
乱离=loạn ly
乳媪=nhũ uẩn
争分夺秒=tranh phân đoạt miễu
争风吃醋=tranh phong ngật thố
事与愿违=sự dữ nguyện vỹ
事实=sự thật
五带=ngũ đới
亚历山大=á lịch san đại
享乐=hưởng lạc
亭长=đình trưởng
人参=nhân sâm
人生朝露=nhân sinh triêu lộ
人质=nhân chí
什么=thậm ma
仆从=bộc tụng
今时=kim thời
仓卒=thảng thốt
仓皇=thảng hoàng
以己度人=dĩ kỷ đạc nhân
以讹传讹=dĩ ngoa truyền ngoa
任事=nhậm sự
任便=nhậm tiện
任命=nhậm mệnh
任咎=nhậm cữu
任用=nhậm dụng
任职=nhậm chức
任贤=nhậm hiền
任重=nhậm trọng
仿佛=phảng phất
众叛亲离=chúng bạn thân li
伙计=khoả kế
会计=cối kế
伞圆=tản viên
传令=truyền lệnh
传单=truyền đơn
传声=truyền thanh
传奇=truyền kỳ
传导=truyền đạo
传授=truyền thụ
传播=truyền bá
传教=truyền giáo
传染=truyền nhiễm
传檄=truyền hịch
传真=truyền chân
传神=truyền thần
传箭=truyền tiễn
传统=truyền thống
传舍=truyến xá
传说=truyền thuyết
传达=truyền đạt
传送=truyền tống
传递=truyền đệ
传颂=truyền tụng
伺隙=tý khích
低调=đê điệu
住址=trú chỉ
住宿=trú túc
住房=trú phòng
住所=trú sở
住持=trú trì
住民=trú dân
住馆=trú quán
作法自毙=tác pháp tự tệǀtác pháp tự tễ
作茧自缚=tác kiển tự phọc
佣金=dụng kim
使君=sứ quân
使命=sứ mệnh
使团=sứ đoàn
使徒=sứ đồ
使者=sứ giả
使臣=sứ thần
使节=sứ tiết
使馆=sứ quán
侊饭=quang phạn
侥幸=kiểu hãnh
促使=xúc sử
促席=xúc tịch
促成=xúc thành
促织=xúc chức
促膝=xúc tất
促进=xúc tiến
促迫=xúc bách
促销=xúc tiêu
俗传=tục truyền
俱乐部=câu lạc bộ
倔头倔脑=quất đầu quất não
倡和=xướng hoạ
债台高筑=trái đài cao túc
倾箱倒箧=khuynh sương đảo kiệp
倾轧=khuynh loát
偃武修文=yển vũ tu văn
停当=đình đáng
偻㑩=lâu la
僚属=liêu thuộc
儒行=nho hạnh
兄弟阋墙=huynh đệ siểm tường
兄长=huynh trưởng
充肠=sung trường
光彩=quang thái
免强=miễn cưỡng
兜捕=đâu bộ
入伙=nhập loã
入木三分=nhập mộc tam phân
八斗才=bát đẩu tài
公主=công chúa
公使=công sứ
公干=công cán
兰若=lan nhã
兴兴头头=hứng hứng đầu đầu
兴高采烈=hứng cao thể liệt
兼并=kiêm tính
内属=nội thuộc
内相=nội tướng
冠世=quán thế
冠军=quán quân
冠桄=quan quang
冠绝=quán tuyệt
冠群=quán quần
冠者=quán giả
冠词=quán từ
冰箱=băng sương
冻疮=đông sang
冻馁=đông nỗi
减少=giảm thiểu
几乎=cơ hồ
出处=xuất xứ
出首=xuất thú
分事=phận sự
分命=phận mệnh
分崩离析=phân băng ly tính
分缘=phận duyên
分道扬镳=phân đạo dương tiêu
分限=phận hạn
列计=liệt kê
刚武=cương vũ
判断=phán đoán
利令智昏=lợi lệnh trí khôn
利比亚=lợi bỉ á
刺史=thứ sử
削足适履=tước túc thích lữ
前仆后继=tiền phốc hậu kế
前怕狼后怕虎=tiền phạ lang, hậu phạ hổ
剑拔弩张=kiếm bạt nõ trương
剖断=phẫu đoán
割舍=cát xả
力竭声嘶=lực kiệt thanh tư
加冠=gia quán
勃兴=bột hứng
勉强=miễn cưỡng
勤干=cần cán
北斗=bắc đẩu
匪伊朝夕=phỉ y triêu tịch
匿隐藏形=nặc ảnh tàng hình
十万八千里=thập vạn bát thiên lí
十八般武艺=thập bát ban võ nghệ
十分=thập phần
千里鹅毛=thiên lí nga mao
午时=ngọ thời
半斤八两=bán cân bát lượng
半晌=bán thưởng
单调=đơn điệu
南无=nam mô
卜相=bốc tướng
占卜=chiêm bốc
占卦=chiêm quái
占星=chiêm tinh
占梦=chiêm mộng
占验=chiêm nghiệm
卧薪尝胆=ngoạ tân thường đảm
卯时=mão thời
印刷=ấn loát
危如累卵=nguy như luỹ noãn
危行=nguy hạnh
卷卷=quyền quyền
厄难=ách nạn
厌恶=yếm ố
去势=khử thế
参与=tham dự
参商=sâm thương
参差=sâm si
及时=cập thời
反叛=phản bạn
反复=phản phúc
反背=phản bội
反间=phản gián
变幻=biến ảo
叟叟=sưu sưu
口传=khẩu truyền
句读=cú đậu
只要=chỉ yếu
叮当=đinh đang
可恶=khả ố
台吉=thai cát
台甫=thai phủ
史乘=sử thặng
叶公好龙=diệp công hiếu long
司令=tư lệnh
司徒=tư đồ
司机=tư cơ
司法=tư pháp
司长=ty trưởng
司马=tư mã
叽哩咕噜=kỷ lý cô lỗ
吃里爬外=ngật lý bà ngoại
合时=hợp thời
同奈=đồng nai
同时=đồng thời
同舟共济=đồng châu cộng tế
同调=đồng điệu
名不虚传=danh bất hư truyền
名分=danh phận
名相=danh tướng
吕钜=lữ cự
吞并=thôn tính
否极泰来=bĩ cực thái lai
否泰=bĩ thái
否隔=bĩ cách
吽牙=ngâu nha
呆僗=ngai lao
告假=cáo giá
呕哑=âu ách
呼号=hô hào
呼吁=hô dụ
呼謈=hô bạc
咈意=phật ý
和韵=hoạ vận
咖啡=ca phê
咯吱=khách chi
品笫=phẩm đệ
哆嗦=xỉ sách
哑子=á tử
哔叽=tất kỷ
哨兵=sáo binh
哨子=sáo tử
哨所=sáo sở
哨探=tiêu thám
哪吒=na tra
哺时=bô thì
唛头=mạch đầu
唠叨=lao thao
啧有烦言=trách hữu phiền ngôn
喑哑=ấm á
喜闻乐见=hỉ văn lạc kiến
嗜好=thị hiếu
嘎那=ca na
噢咻=ủ hủ
图穷匕首见=đồ cùng chuỷ thủ hiện
地分=địa phận
地藏=địa tạng
坐以待毙=toạ dĩ đãi tệ
坐吃山空=toạ ngật sơn không
坐地分赃=toạ địa phân tang
坛场=đàn tràng
垃圾=lạp sắc
埋怨=man oán
塞翁失马=tái ông thất mã
增长=tăng trưởng
复叶=phức diệp
复杂=phức tạp
夏楚=giá sở
夏雨雨人=hạ vũ vú nhân
多么=đa ma
多乐=đa lạc
多分=đa phần
多少=đa thiểu
多时=đa thời
大使=đại sứ
大峡谷=đại hiệp cốc
大敛=đại liệm
大藏经=đại tạng kinh
大难=đại nạn
天使=thiên sứ
天台=thiên thai
夭嬌=yêu kiều
失魂落魄=thất hồn lạc phách
头顿=đầu đột
契丹=khất đan
契阔=khiết khoát
契需=khiếp nhu
好动=hiếu động
好处=hảo xứ
好奇=hiếu kỳ
好学=hiếu học
好战=hiếu chiến
好胜=hiếu thắng
好色=hiếu sắc
如丧考妣=như tang khảo kì
如数家珍=như sổ gia trân
如胶似漆=như dao tự tất
如蚁附膻=như nghĩ phụ thiện
如饥似渴=như cơ tư khát
姆庚寨=mẫu canh trại
委蛇=uy di
娱乐=ngu lạc
嫏嬛=lang hoàn
嫡传=đích truyền
字汇=tự vị
孝行=hiếu hạnh
孟浪=mãng lãng
学行=học hạnh
安乐=an lạc
安分=an phận
安居乐业=an cư lạc nghiệp
安贫乐道=an bần lạc đạo
定分=định phận
宝相=bảo tướng
宝藏=bảo tạng
宣传=tuyên truyền
宫相=cung tướng
宫调=cung điệu
宴安鸩毒=yến an trấm độc
家传=gia truyền
家属=gia thuộc
家谱=gia phả
家长=gia trưởng
容易=dung dị
寅吃卯粮=dần ngật mão lương
寒带=hàn đới
寿终正寝=thọ chung chính thẩm
将信将疑=tương tín tương nghi
将夜=tương dạ
将来=tương lai
将计就计=tương kế tựu kế
将错就错=tương thác tựu thác
尉遲=uất trì
小吃=tiểu khiết
小姐=tiểu thư
小姐姐=tiểu tỷ tỷ
小肚鸡肠=tiểu đỗ kê trường
小试锋芒=tiểu thức phong mang
小题大做=tiểu đề đại tác
少不更事=thiếu bất cánh sự
少安毋躁=thiểu an vô táo
少选=thiểu tuyển
尚父=thượng phủ
尺幅千里=xích bức thiên lí
尽教=tẫn giáo
尽管=tẫn quản
局促=cục xúc
居住=cư trú
居易=cư dị
屏条=bình điều
屛气=bính khí
州长=châu trưởng
巴比伦=ba bỉ luân
巾箱本=cân sương bản
市长=thị trưởng
布施=bố thí
布衣卿相=bố y khanh tướng
师出无名=sơ xuất vô danh
希腊=hy lạp
帮长=bang trưởng
干与=can dự
干事=cán sự
干元=càn nguyên
干办=cán biện
干员=cán viên
干命=càn mệnh
干宅=càn trạch
干才=cán tài
干活=cán hoạt
干纲=càn cương
干练=cán luyện
干象=càn tượng
干路=cán lộ
干部=cán bộ
平地楼台=bình địa lầu đài
平时=bình thời
平易=bình dị
平衡=bình hành
并立=tịnh lập
并肩=tịnh kiên
并蒂=tịnh đế
并进=tịnh tiến
幸灾乐祸=hạnh tai lạc hoạ
幻人=ảo nhân
幻境=ảo cảnh
幻影=ảo ảnh
幻想=ảo tưởng
幻术=ảo thuật
幻梦=ảo mộng
幻灯=ảo đăng
幻觉=ảo giác
幻象=ảo tượng
幻身=ảo thân
应该=ưng cai
弹冠相庆=đàn quan tương khánh
弹劾=đàn hặc
弹指=đàn chỉ
强人所难=cưỡng nhân sở nan
强制=cưỡng chế
强勉=cưỡng miễn
强占=cưỡng chiếm
强奸=cưỡng gian
强弩之末=cường nỏ chi mạt
强胁=cưỡng hiếp
强行=cưỡng hành
强调=cường điệu
强迫=cưỡng bách
当时=đương thời
形影不离=hình ảnh bất ly
彪炳=bưu bỉnh
彭亨=bàng hanh
彭魄=bành bạc
彰善瘅恶=chương thiện đơn ác
彰明较著=chương minh giảo trước
征象=trưng tượng
征集=trưng tập
德黑兰=đức mặc lan
忆度=ức đạc
志行=chí hạnh
忘恩负义=vong ân bội nghĩa
忧郁=ưu uất
快乐=khoái lạc
怆然=sảng nhiên
怎么=chẩm ma
急流勇退=cấp lưu dũng thoái
急难=cấp nạn
总数=tổng sổ
恩将仇报=ân tương cừu báo
悾憁=không tổng
情调=tình điệu
惊弓之鸟=kính cung chi điểu
惹火烧身=nhã hoả thiêu thân
意思=ý tứ
感兴=cảm hứng
愤愤=phấn phấn
懵懂=mộng đổng
战时=chiến thời
所向披靡=sở hướng phi mị
所向无敌=sở hương vô địch
扑面=phốc diện
扫帚=táo trửu
扶摇=phù dao
抢白=thương bạch
报称=báo xứng
披星戴月=phi tinh đới nguyệt
抵抗=đề kháng
抹一鼻子灰=mạt nhất tị tử khôi
担心=đam tâm
拘泥=câu nệ
招降纳叛=chiêu hàng nạp bạn
拜相=bái tướng
拟于不伦=nghĩ ư bất luân
拮据=kiết cư
指东画西=chỉ đông hoạch tây
指天画地=chỉ thiên hoạch địa
按图索骥=án đồ sách ký
按察使=án sát sứ
按时=án thời
挑选=thiêu tuyển
振刷=chấn loát
捕影拿风=bộ ảnh nã phong
捕役=bộ dịch
捕生=bộ sinh
损人利己=tổn nhân lợi kỉ
据实=cứ thật
排长=bài trưởng
探头探脑=tham đầu tham não
探戈=tham qua
提撕=đề tê
揠苗助长=át miêu trợ trưởng
摇头晃脑=dao đầu hoảng não
摇尾乞怜=dao vĩ khất liên
撄宁=oanh ninh
擘划=phách hoạch
擘画=phách hoạch
擢发难数=trạc phát nan sổ
支属=chi thuộc
敏锐=mẫn duệ
救苦救难=cứu khổ cứu nạn
散步=tản bộ
敦促=đôn xúc
数典忘祖=sổ điển vong tổ
数珠=sổ châu
数落=sổ lạc
数见不鲜=sác kiến bất tiên
斤两=cân lượng
斫轮老手=trác luân lão thủ
断肠=đoạn trường
新加坡=tân gia ba
方便面=phương tiện miến
施主=thí chủ
旁系亲属=bàng hệ thân thuộc
无与伦比=vô dữ luận tỉ
无可比拟=vô khả tỉ nỉ
无坚不摧=vô kiên bất thôi
无声无臭=vô danh vô khứu
无往不利=vô vãng vô lợi
无疆=vạn cương
无精打采=vô tinh đả thái
日上三竿=nhật thướng tam can
日就月将=nhật tựu nguyệt tương
旧时=cựu thời
时代=thời đại
时间=thời gian
明枪暗箭=minh thương ám kiếm
明珠暗投=minh chu ám đầu
星移斗转=tinh di đẩu chuyển
景行=cảnh hạnh
晴天霹雳=tinh thiên tịch lịch
暂时=tạm thời
暗中摸索=ám trung mô sách
暴白=bộc bạch
暴露=bộc lộ
暴骨=bộc cốt
更偌=canh nhược
更生=cánh sinh
更行=canh hạnh
曼曼=man man
最少=tối thiểu
月落参横=nguyệt lạc sâm hoành
望风披靡=vọng phong phị mị
朝三暮四=triêu tam mộ tứ
朝不保夕=triêu bất bảo tịch
朝乾夕惕=triêu kiền tịch thích
朝令夕改=triêu lệnh tịch cải
朝发夕至=triêu phát tịch chí
朝秦暮楚=triêu tần tịch sở
朝阳=triêu dương
木雕泥塑=mộc điêu nê cố
未可厚非=vi khả hậu phi
未雨绸缪=vị vũ trù mậtǀvị vũ trù mâu
本分=bổn phận
李傕=lý giác
杞人忧天=khởi nhân ưu thiên
束手待毙=thúc thủ đãi tệ
来着=lai trước
杯水粒粟=bôi thuỷ lập túc
杳如黄鹤=diểu như hoàng hạc
极乐=cực lạc
极圈=cực quyển
构思=cấu tứ
枝指=kì chỉ
枝栖=chi thê
枣椰=tảo da
柏拉图=bá lạp đồ
柏林=bá lâm
柏格森=bá cách sâm
树欲静而风不止=thụ dục tịnh nhi phong bất chỉ
株拘=châu cù
梦幻泡影=mộng hoang bào ảnh
梦梦=mông mông
椎骨=chuy cốt
樊然=phiền nhiên
步调=bộ điệu
武器=vũ khí
武斗=vũ đấu
武晹=vũ dương
武涯=vũ nhai
武装=vũ trang
死得其所=tử đắc kì sở
死灰复燃=tử khôi phục nhiên
死难=tử nạn
殿屎=điện hi
比年=bỉ niên
比目鱼=bỉ mục ngư
毗卢=bì lư
毙监免议=tễ giam miễn nghị
民民=miên miên
气圈=khí quyển
水陆道场=thuỷ lục đạo tràng
求过于供=cầu quá ư cung
沆瀣=hãng dới
沙里淘金=sa lí đào kim
沛然=phái nhiên
没精打采=một tinh đả thái
沦肌浃髓=luân cơ giáp tuỷ
沮丧=trở táng
沮洳=tự như
泡制=bào chế
泡影=bào ảnh
泡面=phao miến
注疏=chú sớ
泰斗=thái đẩu
洇润=yên nhuận
洗心革面=tiển tâm cách diện
洗耳恭听=tiển nhỉ cung thính
济楚=tể sở
济济=tể tể
海参崴=hải sâm uy
浸浔=thâm tầm
消耗=tiêu hao
深湛=thâm trầm
混夷=côn di
渗渗=sấm sấm
渠率=cừ suý
滂沛=bàng phái
滥竽充数=lạm vô sung số
滴水穿石=tích thuỷ xuyên thạch
潦倒=lao đảo
灵丹妙药=linh đơn diệu dược
炮制=bào chế
炮格=bào cách
焙茶=bồi trà
煦妪=hú ủ
照本宣科=chiếu bổn tuyên khoa
照相=chiếu tướng
熨斗=uất đẩu
熨贴=uý thiếp
爆仗=bạo trượng
爆炸=bạo tạc
爆竹=bạo trúc
爆竿=bạo can
牛溲马勃=ngưu sưu mã bột
狼吞虎咽=lang thôn hổ yên
狼狈为奸=lang bối vi gian
猗傩=ả na
獬豸=giải trãi
玩物丧志=ngoạn vật táng chí
现任=hiện nhậm
玳瑁=đại mội
班行=ban hàng
琅玡=lang da
琦瑰=kỳ khôi
瓮中之鳖=ung trung chi biết
甚么=thậm ma
生吞活剥=sinh thôn hoạt bát
用舍行藏=dụng xả hành tàng
田径=điền kinh
电掣=điện xiết
电视监控录像=điện thị giam khống lục tượng
画然=hoạch nhiên
疾言厉色=tật ngôn lịch sắc
疾风劲草=tật phong tri kình thảo
疾首蹙额=tật thủ súc ngạch
登时=đăng thời
白术=bạch truật
白衣卿相=bạch y khanh tướng
百发百中=bách phát bách trúng
百多禄=bá đa lộc
百废俱兴=bách phế cụ hưng
百折不挠=bách chiết bất náo
百无禁忌=bất vô cấm kỵǀbách vô cấm kỵ
皋比=cao bì
皮相=bì tướng
皮里阳秋=bì lí dương thu
盘郁=bàn uất
目不转睛=mục bất chuyển tinh
盲人摸象=manh nhân mô tượng
真相=chân tướng
眼看着=nhãn khán trước
着三不着两=trước tam bất trước lưỡng
着急=trước cấp
着想=trước tưởng
瞠乎其后=xanh hồ kỳ hậu
瞠目结舌=xanh mục kết thiệt
瞬时速度=thuấn thời tốc độ
知己知彼=tri kỉ tri bỉ
破釜沉舟=phá phủ trầm châu
破镜重圆=phá kính trùng viên
硕果仅存=thạc quả cẩn tồn
硙硙=cai cai
碰一鼻子灰=bàng nhất tị tử khôi
磅礴=bàng bạc
磨穿铁砚=ma xuyên thiết nghiên
礨石=lôi thạch
神采=thần thái
禁断=cấm đoán
禅位=thiện vị
离乡背井=lí hương bội tỉnh
离开=ly khai
离离=ly ly
离经判道=li kinh bạn đạo
科斗=khoa đẩu
秘传=bí truyền
稽首=khể thủ
穷乡僻壤=cùng hương tịch nhưỡng
穷兵黩武=cùng binh độc vũ
穷年累世=cùng niên luỹ thế
穷形尽相=cùng hình tận tướng
穷相=cùng tướng
穷途潦倒=cùng đồ lạo đảo
穿过=xuyên qua
窈纠=yểu kiểu
立竿见影=lập can kiến cảnh
立身处世=lập nhân xử thế
笑逐颜开=tiếu tục nhan khai
筮仕=thệ sĩ
箕裘=ki cừu
箕踞=ki cứ
簿书=bộ thư
粥少僧多=chúc thiểu tăng đa
索性=sách tính
紫微斗数=tử vi đẩu số
纠弹=củ đàn
纵横=tung hoành
纵虎归山=tung hổ quy sơn
结实=kết thật
给假=cấp giá
绲戎=hỗn nhung
缅甸=miến điện
缘分=duyên phận
缥渺=phiêu miểu
罔两=võng lượng
置办=trí bạn
美不胜收=mỹ bất thắng thu
羡慕=tiện mộ
耶路撒冷=da lộ tát lãnh
聊胜于无=liêu thắng ư vô
职分=chức phận
股分=cổ phần
肮脏=khảng tảng
肯綮=khải khính
胁肩谄笑=hiếp khiên siển tiếu
背义=bội nghĩa
背信=bội tín
背反=bội phản
背叛=bội phản
背理=bội lý
背礼=bội lễ
背约=bội ước
背逆=bội nghịch
胜平=thăng bình
能干=năng cán
腊魚=tịch ngư
臆断=ức đoán
臊子=táo tử
自惭形秽=tự tàm hình phế
自暴自弃=tự bộc tự khí
自顾不暇=tự cố bất hà
至于=chí ư
至少=chí thiểu
舍不得=xả bất đắc
舍己为人=xả kỷ vị nhân
舍己为公=xả kỷ vị công
舍本逐末=xả bản trục mạt
舍死忘生=xả tử vong sinh
舍生取义=xả sinh thủ nghĩa
舍近求远=xả cận cầu viễn
般若=bát nhã
良莠不齐=lưỡng dữu bất tề
艰屯=gian truân
艰苦卓绝=kiên khổ trác tuyệt
节操=tiết tháo
芚愚=xuân ngu
芦苇=lô vĩ
芹苴=cần thư
英吉利海峡=anh cát lợi hải hiệp
英武=anh vũ
茉莉=mạt lỵ
莽苍=mãng thưởng
菡萏=hạm đạm
萎靡=uỷ mĩ
营养=dinh dưỡng
落魄=lạc thác
葵州=quy châu
蓑蓑=tuy tuy
蔚为大观=uý vị đại quan
蔷薇=tường vi
薄幸=bạc hãnh
虚与委蛇=hư dữ uỷ di
行将就木=hành tương tựu mộc
行情=hàng tình
衣单=y đan
衣锦回乡=ý cẩm hồi hương
表征=biểu trưng
装模作样=trang mô tác dụng
装疯卖傻=trang phong mại soả
裘江=cầu giang
要求=yêu cầu
见危授命=kiến nguy thọ mệnh
见微知著=kiến vi trí trứ
见背=kiến bội
言传身教=ngôn truyền thân giáo
言归正传=ngôn quy chính chuyên
言必有中=ngôn tất hữu trúng
计画=kế hoạch
计较=kế giảo
记载=ký tái
许许=hử hử
诊断=chẩn đoán
诘朝=cật triêu
诘难=cật nạn
诚实=thành thật
该综=cai tông
诸葛=gia cát
象征=tượng trưng
貌合神离=mạo hợp thần ly
责无旁贷=trách vô bàng đại
贤贤易色=hiền hiền dị sắc
质库=chí khố
贼喊捉贼=tặc hãn tróc tặc
赈施=chẩn thí
走马上任=tẩu mã thượng nhậm
跃跃=thích thích
跃跃欲试=dược dược dục thí
跑跑跳跳=bão bão khiêu khiêu
跑跑颠颠=bão bão điên điên
跑马卖解=bão mã mại giải
距离=cự ly
跳踉=khiêu lương
跷勇=kiểu dũng
跷跷=kiểu kiểu
跼促=cục xúc
蹑手蹑脚=nhiếp thủ nhiếp cước
蹭蹬=thặng đặng
身分=thân phận
身毒=quyên độc
轻松=khinh tông
轻歌曼舞=khinh ca man vũ
辟易=tích dịch
辩难=biện nạn
边塞=biên tái
达赖喇嘛=đạt lai lạt ma
迍迍=truân truân
迍邅=truân triên
迦叶=ca diếp
迦蓝=già lam
迷离=mê ly
逆水行舟=nghịch thuỷ hành châu
造次=tháo thứ
逮捕=đãi bộ
逼促=bức xúc
遇难=ngộ nạn
避实击虚=tị thật kích hư
避实就虚=tị thật tựu hư
邅回=triên hồi
那么=na ma
郁蒸=uất chưng
郁金=uất kim
郁陶=uất đào
部分=bộ phận
部属=bộ thuộc
部长=bộ trưởng
醍醐=đề hồ
重修=trùng tu
重启=trùng khải
重奏=trùng tấu
重庆=trùng khánh
重洋=trùng dương
重生=trùng sinh
钩饵=câu nhĩ
钻营=toàn doanh
铁杵磨成针=thiết chử ma thành châm
铺张扬厉=phô trương dương lịch
锥钻=chuỳ chỉ
长年累月=trường niên luỹ nguyệt
长者=trưởng giả
闲情逸致=nhàn tình dật tri
间色=gián sắc
闻名于世=văn danh ư thế
闻过则喜=văn quá tắc hỷ
闻风丧胆=văn phong táng đảm
队长=đội trưởng
阴处=âm xứ
阴郁=âm uất
阿魏=a nguỳ
阿鼻地狱=a tì địa ngục
陆离=lục ly
降魔=hàng ma
降龙伏虎=hàng long phục hổ
陪乘=bồi thặng
陫侧=phỉ trắc
随声附和=tuỳ thân phụ hoạ
随波逐流=tuỳ ba toại lưu
随遇平衡=tuỳ ngộ bình hằng
隐相=ẩn tướng
雀屏=tước bình
集腋成裘=tập dịch thành cầu
霸権=bá quyền
青天霹雳=thanh thiên tịch lịch
靖边=tịnh biên
鞞琫=bính bổng
音耗=âm hao
音调=âm điệu
领主=lãnh chúa
颈椎=cảnh chuy
饮鸩止渴=ẩm trấm chỉ khátǀẩm trậm chỉ khát
饿虎扑食=ngã hổ phốc thực
首相=thủ tướng
马首是瞻=mã thủ thị thiêm
驳错=bác thố
驾轻就熟=giá khinh tựu tục
骨相=cốt tướng
骨膜=cốt mạc
高丽=cao ly
高兴=cao hứng
高行=cao hạnh
高调=cao điệu
鱼游釜中=ngư du phẫu trung
鸟尽弓藏=điểu tận cung tàn
黑洞洞=hắc đỗng đỗng
鼓吹=cổ xuý
鼠肚鸡肠=thử đổ kê trường
龙盘虎剧=long bàn hổ cứ
龙腾虎跃=long đằng hổ diệu
龙飞凤舞=long phi phụng vũ
龟兹=cưu tư
长史=trưởng sử
的当=đích đáng
武当=võ đang
传人=truyền nhân
前任=tiền nhiệm
政使=chính sứ
法相=pháp tướng
星宿=tinh tú
郡主=quận chúa
传承=truyền thừa
重位=trùng vị
传音=truyền âm
甲子=giáp tý
长乐=trường lạc
道长=đạo trưởng
无份=vô phận
仙长=tiên trưởng
长老=trưởng lão
会长=hội trưởng
玉衡=ngọc hành
无相=vô tướng
时效=thời hiệu
重赛=trùng tái
重发=trùng phát
乐器=nhạc khí
院长=viện trưởng
董事长=đổng sự trưởng
重回=trùng hồi
祭司=tế tư
夫长=phu trưởng
曹操=tào tháo
太守=thái thú
船长=thuyền trưởng
族长=tộc trưởng
村长=thôn trưởng
校长=hiệu trưởng
军长=quân trưởng
首长=thủ trưởng
镇长=trấn trưởng
降将=hàng tướng
主公=chúa công
司空=tư không
大宛=đại uyển
投降=đầu hàng
斗篷=đẩu bồng
大难题=đại nan đề
难题=nan đề
司天监=tư thiên giám
南斗=nam đẩu
重出=trùng xuất
军士长=quân sĩ trưởng
长官=trưởng quan
组长=tổ trưởng
警长=cảnh trưởng
局长=cục trưởng
尉迟=uất trì
司鸿=tư hồng
相声=tướng thanh
综合=tổng hợp
道藏=đạo tạng
重名=trùng danh
重溟=trùng minh
长成=trưởng thành
长生=trường sinh
仇恨=thù hận
时空=thời không
指挥使=chỉ huy sứ
真传=chân truyền
时期=thời kỳ
间谍=gián điệp
处长=xử trưởng
主任=chủ nhiệm
长男=trưởng nam
长姐=trưởng tỷ
可汗=khả hãn
长嫂=trưởng tẩu
什长=thập trưởng
降妖=hàng yêu
任务=nhiệm vụ
厂长=xưởng trưởng
厅长=sảnh trưởng
县长=huyện trưởng
神袛=thần kì
重八=trùng bát
洪武=hồng vũ
欢乐=hoan lạc
陆小凤=lục tiểu phụng
貂婵=điêu thuyền
吕凤先=lã phụng tiên
苗人凤=miêu nhân phụng
长孙=trưởng tôn
重活=trùng hoạt
黄易=huỳnh dịch
农家乐=nông gia lạc
区长=khu trưởng
行长=hành trưởng
台长=đài trưởng
缥缈=phiêu miểu
一招=nhất chiêu
重磨=trùng ma
重加=trùng gia
重振=trùng chấn
事象=biến cố
重走=trùng tẩu
三重衣=tam trùng y
乐欲=lạc dục
重云=trùng vân
T-深渊病毒=T - thâm uyên bệnh độc
重掌=trùng chưởng
伯乐=bá lạc
重进=trùng tiến
重查=trùng tra
学长=học trưởng
清藏=thanh tạng
藏南=tạng nam